1111111111
100P000001
1011000111
100E10X0C1
1011000011
1000000001
1001001111
1010001C01
1C10000001
1111111111