1111111111
1001P00001
1011000111
100E1000C1
1111111111