1111111111
100P0001
1011000111
100E0000C1
1111111111