111111
100P01
101101
101E01
111111