11111111
100P0001
10110001
101E00C1
11111111