111111
100P01
101101
101001
111111